....................
....................
........C.X.........
......-######-......
D.G..............GB.
####..G.G.G.G....###
.......G.G.GCG......
......--------......
...--...........--..
....................
.G.G............GAG.
####............####
....................
.1..................
####################
