....................
...G...........BX...
...--..G......---...
....G.--.......G....
...--..........--...
...G.....GA.....G...
...--....--....--...
...CU...........G...
..#--........G.--...
...G........--.G....
...--..........--...
....G...........G...
...--..........--...
.1..................
####################
