....................
B..X................
####...###...G......
........UU...#.G....
....................
G...............-...
#......G............
..-...........AGG...
........GG..#####...
...G....##........GG
....#.............##
..#.................
....................
.1............D.....
####################
