.......G.G.G.......X
...................-
......G.....G.......
..G...-..#..#......A
..#............G..##
...............-....
-........1..........
........###.........
G....G...U......G...
#....#.......G....G.
...G......#..#......
...#..............G.
....................
A..D.....A..C..B.UUU
####################
