....................
....U...............
....#...............
....................
.G......B...D.......
.#......~####....A.U
........G#.#..----##
....#---##X#........
#...#.....-#.C...G..
....#......#----.-..
....#...---.........
..#.#-..............
....#...............
1...#UA....G...G...G
#...####...#...#...#
